{
  "level": [
    [ "s", "s", "d", "s", "s", "d" ],
    [ "s", "t", "s", "s", "p", "d" ],
    [ "t", "p", "h", "t", "s", "t" ],
    [ "s", "p", "h", "d", "t", "d" ],
    [ "s", "d", "s", "t", "h", "t" ],
    [ "d", "s", "p", "s", "p", "p" ]
  ]
}
