{
  "level": [
    [ "s", "s", "d", "s", "s", "d", "s", "s" ],
    [ "s", "t", "s", "s", "p", "d", "t", "s" ],
    [ "s'", "p", "h", "t", "s", "t", "p", "s'" ],
    [ "s", "p", "h", "d", "t", "d", "p", "s" ],
    [ "s", "d", "s", "t", "h", "t", "d", "s" ],
    [ "d", "s", "p", "s", "p", "p", "s", "d" ],
    [ "s", "d", "s", "t", "h", "t", "d", "s" ],
    [ "d", "s", "p", "s", "p", "p", "s", "d" ]
  ]
}
