{
  "level": [
    [ "s", "d", "d", "s", "s", "d", "s", "s" ],
    [ "s", "t", "s", "d", "p", "d", "t", "s" ],
    [ "t", "p", "h", "d", "s", "t", "p", "t" ],
    [ "s", "d", "d", "h", "d", "d", "p", "s" ],
    [ "s", "d", "s", "d", "h", "t", "d", "s" ],
    [ "d", "s", "p", "d", "p", "p", "s", "d" ],
    [ "s", "d", "s", "t", "h", "t", "d", "s" ],
    [ "d", "s", "p", "s", "p", "p", "s", "d" ]
  ]
}
